Psyduck
5
ffffffff
000000ff
f0e1aaff
f0d146ff
3e3e3eff
18
21
7
7
0
2000.0
2000
300.0
500
1
0 0 0,0 0 0,0 0 0,0 0 0,0 0 0,0 0 0,0 0 0,2 1,0 0 0,0 0 0,2 1,0 0 0,0 0 0,0 0 0,0 0 0,0 0 0,0 0 0,0 0 0
0 0 0,0 0 0,0 0 0,0 0 0,0 0 0,0 0 0,0 0 0,2 1,0 0 0,2 1,2 1,0 0 0,2 1,2 1,0 0 0,0 0 0,0 0 0,0 0 0
0 0 0,0 0 0,0 0 0,2 1,2 1,2 1,0 0 0,0 0 0,2 1,2 1,0 0 0,2 1,2 1,0 0 0,0 0 0,0 0 0,0 0 0,0 0 0
0 0 0,0 0 0,2 1,0 0 3,0 0 3,0 0 3,2 1,2 1,2 1,2 1,2 1,0 0 0,0 0 0,0 0 0,0 0 0,0 0 0,0 0 0,0 0 0
0 0 0,2 1,0 0 3,0 0 3,0 0 4,0 0 4,0 0 3,0 0 3,0 0 3,0 0 3,2 1,2 1,0 0 0,0 0 0,0 0 0,0 0 0,0 0 0,0 0 0
2 1,0 0 3,0 0 3,0 0 4,0 0 3,0 0 3,0 0 3,0 0 3,0 0 3,0 0 3,0 0 3,0 0 3,2 1,0 0 0,0 0 0,0 0 0,0 0 0,0 0 0
2 1,0 0 3,0 0 3,0 0 0,0 0 3,0 0 3,1 0,0 0 3,0 0 3,0 0 3,0 0 3,0 0 3,0 0 3,2 1,0 0 0,0 0 0,0 0 0,0 0 0
2 1,0 0 3,0 0 0,2 1,0 0 3,0 0 3,0 0 3,0 0 3,0 0 0,0 0 0,0 0 3,0 0 3,0 0 3,0 0 3,2 1,0 0 0,0 0 0,0 0 0
0 0 0,2 1,0 0 3,0 0 0,0 0 4,0 0 4,0 0 3,0 0 0,2 1,0 0 0,0 0 0,0 0 4,0 0 3,0 0 3,0 0 3,2 1,0 0 0,0 0 0
0 0 0,2 1,0 0 3,0 0 4,0 0 2,0 0 2,0 0 4,0 0 4,0 0 0,0 0 0,0 0 3,0 0 4,0 0 3,0 0 3,0 0 3,2 1,0 0 0,0 0 0
0 0 0,2 1,0 0 4,0 0 2,0 0 2,0 0 2,0 0 2,0 0 2,0 0 4,0 0 3,0 0 3,0 0 3,0 0 3,0 0 3,1 4,0 0 3,2 1,0 0 0
2 1,0 0 2,0 0 2,0 0 2,0 0 2,0 0 2,0 0 2,0 0 2,0 0 2,0 0 4,0 0 3,0 0 4,0 0 3,0 0 3,0 0 3,0 0 3,2 1,0 0 0
2 1,0 0 2,0 0 2,0 0 2,0 0 2,0 0 2,0 0 2,0 0 4,0 0 4,0 0 4,0 0 4,0 0 3,0 0 3,0 0 3,0 0 3,2 1,0 0 0,0 0 0
0 0 0,2 1,0 0 2,0 0 2,0 0 2,0 0 2,0 0 4,0 0 3,0 0 3,0 0 3,0 0 3,0 0 3,0 0 3,0 0 3,2 1,0 0 0,0 0 0,0 0 0
0 0 0,0 0 0,2 1,0 0 4,0 0 4,0 0 4,0 0 3,0 0 3,0 0 3,0 0 3,0 0 3,0 0 3,0 0 3,0 0 3,0 0 4,2 1,2 1,2 1
0 0 0,2 1,2 1,0 0 3,0 0 3,1 2,0 0 3,0 0 3,0 0 3,0 0 3,1 3,0 0 3,0 0 3,0 0 3,0 0 4,0 0 2,0 0 2,2 1
2 1,0 0 2,0 0 2,0 0 4,0 0 3,0 0 3,0 0 3,0 0 3,0 0 3,0 0 3,0 0 3,0 0 3,0 0 3,0 0 4,0 0 2,0 0 2,2 1,0 0 0
0 0 0,2 1,0 0 2,0 0 2,0 0 4,0 0 4,0 0 3,0 0 3,0 0 3,0 0 3,0 0 3,0 0 4,0 0 4,0 0 4,2 1,2 1,0 0 0,0 0 0
0 0 0,0 0 0,2 1,2 1,0 0 2,0 0 2,2 1,0 0 4,0 0 4,0 0 4,0 0 4,0 0 2,0 0 2,2 1,0 0 0,0 0 0,0 0 0,0 0 0
0 0 0,0 0 0,0 0 0,0 0 0,2 1,2 1,0 0 0,2 1,0 0 2,0 0 2,0 0 2,0 0 2,2 1,0 0 0,0 0 0,0 0 0,0 0 0,0 0 0
0 0 0,0 0 0,0 0 0,0 0 0,0 0 0,0 0 0,0 0 0,0 0 0,2 1,2 1,2 1,2 1,0 0 0,0 0 0,0 0 0,0 0 0,0 0 0,0 0 0
