Abstraction
5
000000ff
ffffffff
ffe300ff
ff0000ff
111379ff
16
16
5
6
1
2000.0
2000
120.0
250
1
2 0,2 0,2 0,2 0,2 0,2 0,2 0,2 0,2 0,2 0,2 0,2 0,2 0,2 0,2 0,2 0
2 0,0 1 1,0 1 1,0 1 0,0 1 1,0 1 1,0 1 1,0 1 1,0 1 0,0 1 2,0 1 2,0 1 2,0 1 2,0 1 0,0 1 1,2 0
2 0,0 1 0,0 1 0,0 1 0,0 1 0,0 1 0,0 1 0,0 1 0,0 1 0,0 1 0,0 1 0,0 1 0,0 1 0,0 1 0,0 1 1,2 0
2 0,0 1 1,0 1 0,0 1 3,0 1 3,0 1 3,0 1 3,0 1 3,0 1 0,0 1 2,0 1 2,0 1 2,0 1 2,0 1 0,0 1 1,2 0
2 0,0 1 1,0 1 0,0 1 3,1 3,0 1 3,0 1 3,0 1 3,0 1 0,0 1 2,0 1 2,1 2,0 1 2,0 1 0,0 1 1,2 0
2 0,0 1 0,0 1 0,0 1 3,0 1 3,0 1 3,0 1 3,0 1 3,0 1 0,0 1 0,0 1 0,0 1 0,0 1 0,0 1 0,0 1 1,2 0
2 0,0 1 1,0 1 0,0 1 3,0 1 3,0 1 3,0 1 3,0 1 3,0 1 0,0 1 1,0 1 1,0 1 0,0 1 1,0 1 0,0 1 1,2 0
2 0,0 1 1,0 1 0,0 1 3,0 1 3,0 1 3,0 1 3,0 1 3,0 1 0,0 1 1,0 1 1,0 1 0,0 1 1,0 1 0,1 1,2 0
2 0,0 1 1,0 1 0,0 1 0,0 1 0,0 1 0,0 1 0,0 1 0,0 1 0,0 1 0,0 1 0,0 1 0,0 1 0,0 1 0,0 1 1,2 0
2 0,0 1 1,0 1 0,0 1 0,0 1 0,0 1 0,0 1 0,0 1 1,0 1 1,0 1 0,0 1 1,0 1 1,0 1 1,0 1 0,0 1 1,2 0
2 0,0 1 0,0 1 0,0 1 0,1 0,0 1 0,0 1 0,0 1 0,0 1 0,0 1 0,0 1 0,0 1 0,0 1 0,0 1 0,0 1 0,2 0
2 0,2 2,0 1 0,0 1 0,0 1 0,0 1 0,0 1 0,0 1 1,0 1 1,0 1 0,0 1 4,0 1 4,1 4,0 1 0,0 1 0,2 0
2 0,2 2,0 1 0,0 1 0,0 1 0,0 1 0,0 1 0,0 1 0,0 1 0,0 1 0,0 1 4,0 1 4,0 1 4,0 1 0,2 3,2 0
2 0,2 2,0 1 0,0 1 1,0 1 1,0 1 1,0 1 0,0 1 0,0 1 0,0 1 0,0 1 0,0 1 0,0 1 0,0 1 0,2 3,2 0
2 0,2 2,0 1 0,0 1 1,0 1 1,0 1 1,0 1 0,0 1 1,0 1 1,0 1 1,0 1 1,0 1 1,0 1 1,0 1 0,2 3,2 0
2 0,2 0,2 0,2 0,2 0,2 0,2 0,2 0,2 0,2 0,2 0,2 0,2 0,2 0,2 0,2 0
