Son of Man
8
ffffffff
6b726aff
b4d3d6ff
eddecbff
bf8a5aff
10100aff
aea645ff
cd3329ff
15
22
5
7
0
2000.0
2000
220.0
600
1
0 0 2,0 0 2,0 0 2,0 0 2,0 0 2,0 0 2,0 0 2,0 0 2,0 0 2,0 0 2,0 0 2,0 0 2,0 0 2,0 0 2,0 0 2
0 0 2,1 2,0 0 2,0 0 2,0 0 2,0 0 2,0 0 2,0 0 2,0 0 2,0 0 2,0 0 2,0 0 2,0 0 2,0 0 2,0 0 2
0 0 2,0 0 2,0 0 2,0 0 2,0 0 2,0 0 5,0 0 5,0 0 5,0 0 5,0 0 5,0 0 2,0 0 2,0 0 2,1 6,0 0 2
0 0 2,0 0 2,0 0 2,0 0 2,0 0 2,0 0 5,0 0 5,0 0 5,0 0 5,0 0 5,0 0 2,0 0 2,0 0 2,0 0 2,0 0 2
0 0 2,0 0 2,0 0 2,0 0 2,0 0 5,0 0 5,0 0 5,0 0 6,0 0 5,0 0 5,0 0 5,0 0 2,0 0 2,0 0 2,0 0 2
0 0 2,0 0 2,0 0 2,0 0 2,0 0 2,0 0 4,0 0 6,0 0 6,0 0 6,0 0 4,0 0 2,0 0 2,0 0 2,0 0 2,0 0 2
0 0 2,0 0 2,0 0 2,0 0 2,0 0 2,0 0 4,0 0 6,0 0 6,0 0 6,0 0 4,0 0 2,0 0 2,0 0 2,0 0 2,0 0 2
0 0 2,0 0 2,0 0 2,0 0 2,0 0 2,0 0 4,0 0 6,0 0 6,0 0 6,0 0 4,0 0 2,0 0 2,0 0 2,1 4,0 0 2
0 0 2,0 0 2,0 0 2,0 0 2,0 0 2,0 0 2,0 0 4,0 0 4,0 0 4,0 0 2,0 0 2,0 0 2,0 0 2,0 0 2,0 0 2
1 0,0 0 2,0 0 2,0 0 2,0 0 2,0 0 5,0 0 0,0 0 0,0 0 0,0 0 5,0 0 2,0 0 2,0 0 2,0 0 2,0 0 2
0 0 2,0 0 2,0 0 2,0 0 5,0 0 5,0 0 5,0 0 0,2 7,0 0 0,0 0 5,0 0 5,0 0 5,0 0 2,0 0 2,0 0 2
0 0 2,0 0 3,1 3,0 0 5,0 0 5,0 0 5,0 0 0,2 7,0 0 0,0 0 5,0 0 5,0 0 5,0 0 2,2 3,0 0 2
0 0 3,0 0 3,0 0 3,0 0 5,0 0 5,0 0 5,0 0 5,2 7,0 0 5,0 0 5,0 0 5,0 0 5,0 0 3,0 0 3,0 0 3
0 0 2,0 0 2,0 0 2,0 0 5,0 0 5,0 0 5,0 0 5,0 0 5,0 0 5,0 0 5,0 0 5,0 0 5,0 0 2,0 0 2,0 0 2
0 0 2,0 0 2,0 0 2,0 0 5,0 0 5,0 0 5,0 0 5,0 0 5,0 0 5,0 0 5,0 0 5,0 0 5,0 0 2,0 0 2,0 0 2
0 0 2,0 0 2,0 0 2,0 0 5,0 0 5,0 0 5,0 0 5,0 0 5,0 0 5,0 0 5,0 0 5,0 0 5,0 0 2,0 0 2,0 0 2
0 0 2,0 0 2,0 0 2,0 0 5,0 0 5,0 0 5,0 0 5,0 0 5,0 0 5,1 5,0 0 5,0 0 5,0 0 2,0 0 2,0 0 2
0 0 1,0 0 1,0 0 1,0 0 5,0 0 5,0 0 5,0 0 5,0 0 5,0 0 5,0 0 5,0 0 5,0 0 5,0 0 1,0 0 1,0 0 1
0 0 1,0 0 1,0 0 1,0 0 5,0 0 5,0 0 5,0 0 5,0 0 5,0 0 5,0 0 5,0 0 5,0 0 5,0 0 1,0 0 1,0 0 1
0 0 1,0 0 1,0 0 1,0 0 5,0 0 5,0 0 5,0 0 5,0 0 5,0 0 5,0 0 5,0 0 5,0 0 5,0 0 1,0 0 1,0 0 1
0 0 1,0 0 1,0 0 1,2 4,0 0 5,0 0 5,0 0 5,0 0 5,0 0 5,0 0 5,0 0 5,2 4,0 0 1,0 0 1,0 0 1
0 0 1,0 0 1,0 0 1,0 0 1,0 0 5,0 0 5,0 0 5,0 0 5,0 0 5,0 0 5,0 0 5,0 0 1,0 0 1,0 0 1,1 1
