Starry
5
000000ff
ffffffff
111379ff
fae224ff
5687a3ff
14
12
2
2
1
2000.0
2000
200.0
300
1
2 0,2 0,2 0,2 0,2 0,2 0,2 0,2 0,2 0,2 0,1 3,2 0,2 0,2 0
2 0,0 1 2,0 1 2,0 1 2,0 1 2,0 1 2,0 1 2,0 1 2,0 1 2,0 1 2,0 1 2,0 1 2,0 1 2,2 0
2 0,0 1 2,2 3,0 1 2,0 1 0,0 1 2,2 3,0 1 2,0 1 2,0 1 2,0 1 3,0 1 2,0 1 2,2 0
2 0,0 1 4,0 1 2,0 1 0,0 1 2,0 1 2,0 1 2,0 1 4,0 1 2,0 1 3,0 1 3,0 1 3,0 1 2,2 0
2 0,0 1 4,0 1 4,0 1 0,0 1 0,0 1 4,0 1 4,0 1 4,0 1 4,0 1 2,0 1 3,0 1 2,0 1 2,2 0
2 0,2 3,0 1 4,0 1 0,0 1 0,0 1 4,0 1 2,0 1 4,0 1 4,0 1 2,0 1 2,0 1 2,0 1 2,2 0
2 0,0 1 2,0 1 2,0 1 0,0 1 0,0 1 2,0 1 2,2 3,0 1 2,0 1 2,0 1 4,0 1 4,0 1 4,1 4
2 0,0 1 2,0 1 0,0 1 0,0 1 0,0 1 2,0 1 2,0 1 2,0 1 4,0 1 4,0 1 4,2 3,0 1 2,2 0
1 0,0 1 2,0 1 0,0 1 0,0 1 0,0 1 2,0 1 4,0 1 4,0 1 4,0 1 4,0 1 2,0 1 2,0 1 2,2 0
2 0,0 1 2,0 1 0,0 1 0,0 1 0,0 1 4,0 1 4,0 1 2,2 3,0 1 2,0 1 2,0 1 2,0 1 2,2 0
2 0,0 1 2,0 1 0,0 1 0,0 1 0,0 1 0,0 1 2,0 1 2,0 1 2,0 1 2,0 1 2,0 1 2,0 1 2,2 0
2 0,2 0,2 0,2 0,2 0,2 0,2 0,2 0,2 0,2 0,2 0,1 2,2 0,2 0
