Pearl
8
000000ff
ffffffff
00cbfeff
371300ff
ff933aff
ffdbacff
ff0000ff
ffe300ff
12
14
2
2
1
2000.0
2000
90.0
250
1
2 0,2 0,2 0,2 0,1 3,2 0,2 0,2 0,1 5,2 0,2 0,2 0
2 0,0 1 3,0 1 3,0 1 3,0 1 3,0 1 3,0 1 3,0 1 3,0 1 3,0 1 3,0 1 3,2 0
2 0,0 1 3,0 1 3,0 1 3,0 1 3,0 1 3,0 1 3,0 1 3,0 1 3,0 1 3,0 1 3,1 7
2 0,0 1 3,0 1 3,0 1 3,0 1 3,0 1 2,0 1 7,0 1 3,0 1 3,0 1 3,0 1 3,2 0
1 2,0 1 3,0 1 3,0 1 3,0 1 2,0 1 2,0 1 2,0 1 7,0 1 3,0 1 3,0 1 3,2 0
2 0,0 1 3,0 1 3,0 1 3,0 1 5,0 1 5,0 1 2,0 1 7,0 1 3,0 1 3,0 1 3,2 0
2 0,0 1 3,0 1 3,0 1 3,0 1 5,0 1 5,2 6,0 1 7,0 1 3,0 1 3,0 1 3,2 0
2 0,0 1 3,0 1 3,0 1 3,0 1 3,0 1 5,0 1 1,0 1 7,0 1 7,0 1 3,0 1 3,2 0
2 0,0 1 3,0 1 3,0 1 3,0 1 3,0 1 1,0 1 1,0 1 7,0 1 7,0 1 3,0 1 3,2 0
2 0,0 1 3,0 1 3,0 1 3,0 1 5,0 1 4,0 1 4,0 1 4,0 1 7,2 2,0 1 3,2 0
2 0,0 1 3,0 1 3,0 1 3,0 1 4,0 1 4,0 1 4,0 1 4,2 2,0 1 3,0 1 3,2 0
2 0,0 1 3,0 1 3,0 1 4,0 1 4,0 1 4,0 1 4,0 1 4,0 1 4,0 1 3,0 1 3,1 4
2 0,0 1 3,0 1 3,0 1 4,0 1 4,0 1 4,0 1 4,0 1 4,0 1 4,0 1 3,0 1 3,2 0
2 0,2 0,2 0,2 0,2 0,2 0,2 0,2 0,2 0,2 0,2 0,2 0
