Amogus
4
0000ffff
505050ff
00e8ffff
ffffffff
4
5
2
2
1
18.796854
45
10.0
31
0
1 1,0 3 0,2 0,0 3 0
0 3 0,0 3 0,0 3 2,0 3 2
0 3 0,0 3 0,0 3 0,0 3 0
1 2,0 3 0,0 3 0,0 3 0
1 0,0 3 0,0 3 1,0 3 0
