Kanagawa
4
000000ff
ffffffff
111379ff
e4cfabff
14
12
2
2
1
2000.0
2000
60.0
200
1
2 0,2 0,1 3,2 0,2 0,2 0,2 0,2 0,2 0,2 0,1 2,2 0,2 0,2 0
2 0,0 1 3,0 1 3,0 1 3,0 1 3,0 1 3,0 1 3,0 1 3,0 1 3,0 1 3,0 1 3,0 1 3,0 1 3,2 0
2 0,0 1 3,0 1 3,0 1 3,0 1 3,0 1 3,0 1 3,0 1 3,0 1 3,0 1 3,0 1 3,0 1 3,0 1 3,2 0
2 0,0 1 3,0 1 3,0 1 3,0 1 1,0 1 1,0 1 1,0 1 3,0 1 3,0 1 3,0 1 3,0 1 3,0 1 3,2 0
2 0,0 1 3,0 1 3,0 1 1,0 1 2,0 1 2,0 1 2,0 1 1,0 1 3,0 1 3,0 1 3,0 1 3,0 1 3,1 1
2 0,0 1 3,0 1 1,0 1 2,0 1 2,0 1 2,0 1 3,0 1 2,0 1 3,0 1 3,0 1 3,0 1 3,0 1 3,2 0
2 0,0 1 1,0 1 2,0 1 2,0 1 2,0 1 2,0 1 3,0 1 3,0 1 3,0 1 3,0 1 3,0 1 3,0 1 1,2 0
2 0,0 1 1,0 1 2,0 1 2,0 1 2,0 1 2,0 1 2,0 1 3,0 1 3,0 1 3,0 1 3,0 1 1,0 1 2,2 0
2 0,0 1 1,0 1 2,0 1 2,0 1 1,0 1 1,0 1 1,0 1 1,0 1 1,0 1 1,0 1 1,0 1 2,0 1 2,2 0
2 0,0 1 2,0 1 2,0 1 1,0 1 1,0 1 1,0 1 2,0 1 2,0 1 2,0 1 2,0 1 2,0 1 2,0 1 2,2 0
2 0,0 1 1,0 1 1,0 1 2,0 1 2,0 1 2,0 1 2,0 1 2,0 1 2,0 1 2,0 1 2,0 1 2,0 1 2,2 0
2 0,2 0,2 0,2 0,2 0,2 0,2 0,2 0,2 0,2 0,2 0,2 0,2 0,2 0
