Watermelon
6
e6e6e6ff
ffffffff
444f0eff
d6b69bff
bb170bff
491c13ff
13
13
8
6
1
1000.0
1000
100.0
200
1
0 0 0,0 0 0,0 0 0,0 0 0,0 0 0,0 0 0,0 0 0,0 0 0,0 0 0,0 1 2,0 1 2,0 0 0,0 1 0
0 0 0,0 0 0,1 0,0 0 0,0 0 0,0 0 0,0 0 0,0 0 0,0 1 4,0 1 3,0 1 2,0 1 2,1 2
0 0 0,0 0 0,0 0 0,0 0 0,0 0 0,0 0 0,0 0 0,0 1 4,0 1 4,0 1 4,0 1 3,0 1 2,0 1 2
0 0 0,0 0 0,0 0 0,0 0 0,0 0 0,0 0 0,0 1 4,0 1 4,2 5,0 1 4,0 1 3,0 1 2,0 1 2
0 0 0,0 0 0,0 0 0,0 0 0,1 4,0 1 4,0 1 4,0 1 4,0 1 4,0 1 4,0 1 3,0 1 2,0 1 2
0 0 0,0 0 0,0 0 0,0 0 0,0 1 4,0 1 4,0 1 4,2 5,0 1 4,0 1 4,0 1 3,0 1 2,0 1 2
0 0 0,0 0 0,0 0 0,0 1 4,0 1 4,0 1 4,0 1 4,0 1 4,0 1 4,0 1 4,0 1 3,0 1 2,0 1 2
0 0 0,0 0 0,0 1 4,0 1 4,0 1 4,2 5,0 1 4,0 1 4,0 1 4,0 1 4,0 1 3,0 1 2,0 1 2
0 0 0,0 1 4,0 1 4,2 5,0 1 4,0 1 4,0 1 4,0 1 4,0 1 4,0 1 3,0 1 2,0 1 2,0 0 0
0 1 2,0 1 3,0 1 4,0 1 4,0 1 4,0 1 4,0 1 4,0 1 4,0 1 3,0 1 2,0 1 2,0 1 2,0 0 0
0 1 2,0 1 2,0 1 3,0 1 3,0 1 3,0 1 3,0 1 3,0 1 3,0 1 2,0 1 2,0 1 2,0 0 0,0 0 0
0 0 0,0 1 2,0 1 2,0 1 2,0 1 2,0 1 2,0 1 2,0 1 2,0 1 2,0 1 2,0 0 0,0 0 0,1 3
0 0 0,0 0 0,0 0 0,0 1 2,0 1 2,0 1 2,0 1 2,0 1 2,0 0 0,0 0 0,0 0 0,0 0 0,0 0 0
