Sunflowers
8
000000ff
ffffffff
f28a16ff
bce2e7ff
048302ff
f6e136ff
f7bf9bff
ba4107ff
12
14
2
2
1
2000.0
2000
200.0
350
1
2 0,2 0,2 0,1 5,2 0,2 0,2 0,2 0,2 0,2 0,2 0,2 0
2 0,0 1 3,0 1 3,0 1 3,0 1 3,0 1 3,0 1 3,0 1 3,0 1 3,0 1 3,0 1 3,2 0
2 0,0 1 3,0 1 3,0 1 3,0 1 3,0 1 5,0 1 3,0 1 3,0 1 5,0 1 3,0 1 3,2 0
2 0,0 1 3,0 1 5,0 1 3,0 1 5,0 1 3,0 1 5,0 1 5,2 7,0 1 5,0 1 3,2 0
2 0,0 1 3,0 1 3,0 1 5,2 7,0 1 5,0 1 3,0 1 5,0 1 3,0 1 3,0 1 3,1 3
2 0,0 1 3,0 1 5,0 1 3,0 1 5,0 1 3,0 1 5,2 7,0 1 5,0 1 3,0 1 3,2 0
2 0,0 1 3,0 1 3,0 1 5,2 4,0 1 5,2 4,0 1 5,0 1 3,0 1 3,0 1 3,2 0
1 2,0 1 3,2 4,0 1 5,0 1 3,2 7,0 1 5,0 1 3,2 4,0 1 3,0 1 3,1 6
2 0,0 1 3,0 1 3,0 1 3,0 1 2,0 1 5,0 1 2,0 1 2,0 1 3,0 1 5,0 1 3,2 0
2 0,0 1 3,0 1 3,0 1 3,0 1 2,0 1 2,0 1 2,0 1 2,0 1 3,0 1 3,0 1 3,2 0
2 0,0 1 2,0 1 2,0 1 2,0 1 6,0 1 6,0 1 6,0 1 6,0 1 2,0 1 2,0 1 2,2 0
2 0,0 1 2,0 1 2,0 1 2,0 1 2,0 1 6,0 1 6,0 1 2,0 1 2,0 1 2,0 1 2,2 0
2 0,0 1 2,0 1 2,0 1 2,0 1 2,0 1 2,0 1 2,0 1 2,0 1 2,0 1 2,0 1 2,2 0
2 0,2 0,2 0,2 0,2 0,2 0,2 0,2 0,2 0,2 0,2 0,2 0
